//MAP CONVERTED BY dmm2tgm.py THIS HEADER COMMENT PREVENTS RECONVERSION, DO NOT REMOVE
"aW" = (
/obj/decal/tile_edge/stripe/extra_big{
	dir = 5
	},
/obj/decal/tile_edge/stripe/extra_big{
	dir = 9;
	icon_state = "xtra_bigstripe-corner2"
	},
/obj/map/light/cyan,
/turf/simulated/floor/engine/glow/blue,
/area/station/engine/singcore)
"bT" = (
/obj/machinery/power/data_terminal,
/obj/cable{
	icon_state = "0-4"
	},
/obj/decal/mule/dropoff,
/obj/decal/tile_edge/stripe/extra_big{
	dir = 1
	},
/obj/decal/tile_edge/stripe/extra_big,
/turf/simulated/floor/black,
/area/station/engine/inner)
"ce" = (
/turf/simulated/floor/yellow/side,
/area/station/engine/inner)
"cj" = (
/obj/cable{
	icon_state = "0-8"
	},
/obj/cable{
	icon_state = "0-2"
	},
/obj/mapping_helper/wingrille_spawn/auto/crystal,
/turf/simulated/floor/plating/jen,
/area/station/engine/singcore)
"cw" = (
/obj/cable{
	icon_state = "0-2"
	},
/obj/cable{
	icon_state = "0-4"
	},
/obj/cable{
	icon_state = "0-8"
	},
/obj/mapping_helper/wingrille_spawn/auto/crystal,
/turf/simulated/floor/plating/jen,
/area/station/engine/singcore)
"cx" = (
/obj/cable{
	icon_state = "0-2"
	},
/obj/cable,
/obj/mapping_helper/wingrille_spawn/auto/crystal,
/turf/simulated/floor/plating/jen,
/area/station/engine/singcore)
"cB" = (
/turf/simulated/floor/engine,
/area/station/engine/singcore)
"cF" = (
/obj/decal/tile_edge/stripe/big{
	dir = 1
	},
/turf/simulated/floor/yellow/side{
	dir = 8
	},
/area/station/engine/inner)
"dm" = (
/obj/item/device/radio/intercom/loudspeaker/speaker/south{
	pixel_y = 24
	},
/obj/cable/reinforced{
	icon_state = "4-8-thick"
	},
/obj/machinery/computer/announcement/station/engineering,
/turf/simulated/floor/yellow/side{
	dir = 6
	},
/area/station/engine/inner)
"dx" = (
/obj/cable{
	icon_state = "0-4"
	},
/obj/cable{
	icon_state = "0-8"
	},
/obj/mapping_helper/wingrille_spawn/auto/crystal,
/turf/simulated/floor/plating/jen,
/area/station/engine/singcore)
"dE" = (
/obj/decal/tile_edge/stripe/big,
/obj/decal/tile_edge/stripe/big{
	dir = 1
	},
/obj/decal/tile_edge/stripe/big{
	dir = 10;
	icon_state = "bigstripe-corner2"
	},
/obj/decal/tile_edge/stripe/big{
	dir = 9;
	icon_state = "bigstripe-corner2"
	},
/obj/map/light/cyan,
/turf/simulated/floor/engine/glow/blue,
/area/station/engine/singcore)
"dT" = (
/obj/machinery/emitter{
	dir = 4
	},
/turf/simulated/floor/yellow/side,
/area/station/engine/inner)
"eI" = (
/obj/cable{
	icon_state = "1-8"
	},
/turf/simulated/floor,
/area/station/engine/inner)
"eW" = (
/obj/decal/tile_edge/stripe/extra_big{
	dir = 1
	},
/obj/decal/tile_edge/stripe/extra_big,
/obj/cable{
	icon_state = "4-8"
	},
/turf/simulated/floor/black,
/area/station/engine/inner)
"gr" = (
/obj/cable/reinforced{
	icon_state = "1-2-thick"
	},
/turf/simulated/floor/yellow/side{
	dir = 8
	},
/area/station/engine/inner)
"gL" = (
/turf/simulated/floor/yellow/side{
	dir = 1
	},
/area/station/engine/inner)
"gR" = (
/obj/decal/tile_edge/stripe/big{
	dir = 1
	},
/obj/decal/tile_edge/stripe/big,
/obj/decal/tile_edge/stripe/big{
	dir = 5;
	icon_state = "bigstripe-corner2"
	},
/obj/decal/tile_edge/stripe/big{
	dir = 6;
	icon_state = "bigstripe-corner2"
	},
/obj/map/light/cyan,
/turf/simulated/floor/engine/glow/blue,
/area/station/engine/singcore)
"ho" = (
/obj/cable{
	icon_state = "0-2"
	},
/obj/cable,
/obj/cable{
	icon_state = "0-4"
	},
/obj/mapping_helper/wingrille_spawn/auto/crystal,
/turf/simulated/floor/plating/jen,
/area/station/engine/singcore)
"iJ" = (
/obj/decal/tile_edge/stripe/extra_big,
/obj/map/light/cyan,
/turf/simulated/floor/engine/glow/blue,
/area/station/engine/singcore)
"jn" = (
/turf/simulated/floor/yellow/side{
	dir = 8
	},
/area/station/engine/inner)
"jL" = (
/obj/machinery/power/data_terminal,
/obj/machinery/field_generator,
/obj/cable{
	icon_state = "0-4"
	},
/obj/cable,
/obj/decal/tile_edge/stripe/extra_big{
	dir = 10;
	icon_state = "xtra_bigstripe-corner2"
	},
/obj/map/light/cyan,
/turf/simulated/floor/engine/glow/blue,
/area/station/engine/singcore)
"jO" = (
/obj/decal/tile_edge/stripe/extra_big{
	dir = 10
	},
/obj/decal/tile_edge/stripe/extra_big{
	dir = 9;
	icon_state = "xtra_bigstripe-corner2"
	},
/obj/map/light/cyan,
/turf/simulated/floor/engine/glow/blue,
/area/station/engine/singcore)
"kg" = (
/obj/cable{
	icon_state = "1-2"
	},
/obj/decal/tile_edge/stripe/big,
/obj/decal/tile_edge/stripe/big{
	dir = 1
	},
/obj/decal/tile_edge/stripe/big{
	dir = 9;
	icon_state = "bigstripe-corner2"
	},
/obj/decal/tile_edge/stripe/big{
	dir = 10;
	icon_state = "bigstripe-corner2"
	},
/obj/machinery/door/airlock/pyro/external{
	dir = 4;
	name = "Singularity Core"
	},
/obj/mapping_helper/access/engineering,
/turf/simulated/floor/black/side{
	dir = 4
	},
/area/station/engine/singcore)
"ln" = (
/obj/cable/reinforced{
	icon_state = "1-2-thick"
	},
/turf/simulated/floor/yellow/side{
	dir = 4
	},
/area/station/engine/inner)
"mO" = (
/obj/cable/reinforced{
	icon_state = "1-2-thick"
	},
/obj/cable{
	icon_state = "4-8"
	},
/turf/simulated/floor,
/area/station/engine/inner)
"of" = (
/obj/decal/tile_edge/stripe/extra_big{
	dir = 6
	},
/obj/decal/tile_edge/stripe/extra_big{
	dir = 5;
	icon_state = "xtra_bigstripe-corner2"
	},
/obj/map/light/cyan,
/turf/simulated/floor/engine/glow/blue,
/area/station/engine/singcore)
"pi" = (
/turf/simulated/floor/yellow/corner{
	dir = 8
	},
/area/station/engine/inner)
"pI" = (
/obj/machinery/power/collector_control,
/obj/cable/reinforced{
	icon_state = "0-4-thick"
	},
/obj/cable/reinforced{
	icon_state = "0-8-thick"
	},
/turf/simulated/floor/yellow/side,
/area/station/engine/inner)
"qg" = (
/mob/living/carbon/human/npc/monkey/mr_rathen,
/turf/simulated/floor/engine,
/area/station/engine/singcore)
"qt" = (
/obj/decal/tile_edge/stripe/big{
	dir = 4
	},
/obj/decal/tile_edge/stripe/big{
	dir = 8
	},
/obj/decal/tile_edge/stripe/big{
	dir = 9;
	icon_state = "bigstripe-corner2"
	},
/obj/decal/tile_edge/stripe/big{
	dir = 5;
	icon_state = "bigstripe-corner2"
	},
/obj/cable{
	icon_state = "0-4"
	},
/obj/cable{
	icon_state = "0-8"
	},
/obj/cable{
	icon_state = "0-2"
	},
/obj/machinery/door/airlock/pyro/external{
	name = "Singularity Core"
	},
/obj/mapping_helper/access/engineering,
/turf/simulated/floor/black/side,
/area/station/engine/singcore)
"qL" = (
/obj/cable{
	icon_state = "1-2"
	},
/turf/simulated/floor/engine,
/area/station/engine/singcore)
"rl" = (
/obj/cable{
	icon_state = "4-8"
	},
/turf/simulated/floor/yellow/side{
	dir = 1
	},
/area/station/engine/inner)
"tv" = (
/obj/item/device/radio/intercom/loudspeaker/speaker/north{
	pixel_y = -10
	},
/turf/simulated/floor/yellow/side{
	dir = 5
	},
/area/station/engine/inner)
"ua" = (
/obj/decal/tile_edge/stripe/extra_big{
	dir = 4
	},
/obj/map/light/cyan,
/turf/simulated/floor/engine/glow/blue,
/area/station/engine/singcore)
"ux" = (
/obj/machinery/power/data_terminal,
/obj/machinery/field_generator,
/obj/cable{
	icon_state = "0-8"
	},
/obj/cable{
	icon_state = "0-2"
	},
/obj/decal/tile_edge/stripe/extra_big{
	dir = 5;
	icon_state = "xtra_bigstripe-corner2"
	},
/obj/map/light/cyan,
/turf/simulated/floor/engine/glow/blue,
/area/station/engine/singcore)
"uF" = (
/obj/item/device/radio/intercom/loudspeaker/speaker/north{
	pixel_y = -10
	},
/turf/simulated/floor/yellow/side{
	dir = 9
	},
/area/station/engine/inner)
"uU" = (
/obj/cable{
	icon_state = "1-2"
	},
/obj/decal/tile_edge/stripe/big,
/obj/decal/tile_edge/stripe/big{
	dir = 1
	},
/obj/decal/tile_edge/stripe/big{
	dir = 6;
	icon_state = "bigstripe-corner2"
	},
/obj/decal/tile_edge/stripe/big{
	dir = 5;
	icon_state = "bigstripe-corner2"
	},
/obj/machinery/door/airlock/pyro/external{
	dir = 4;
	name = "Singularity Core"
	},
/obj/mapping_helper/access/engineering,
/turf/simulated/floor/black/side{
	dir = 8
	},
/area/station/engine/singcore)
"vk" = (
/obj/cable/reinforced{
	icon_state = "1-2-thick"
	},
/turf/simulated/floor/yellow/side{
	dir = 6
	},
/area/station/engine/inner)
"vQ" = (
/obj/machinery/power/data_terminal,
/obj/machinery/field_generator,
/obj/cable{
	icon_state = "0-8"
	},
/obj/cable,
/obj/decal/tile_edge/stripe/extra_big{
	dir = 6;
	icon_state = "xtra_bigstripe-corner2"
	},
/obj/map/light/cyan,
/turf/simulated/floor/engine/glow/blue,
/area/station/engine/singcore)
"xO" = (
/obj/cable{
	icon_state = "0-4"
	},
/obj/cable,
/obj/mapping_helper/wingrille_spawn/auto/crystal,
/turf/simulated/floor/plating/jen,
/area/station/engine/singcore)
"yk" = (
/obj/decal/tile_edge/stripe/big{
	dir = 4
	},
/obj/decal/tile_edge/stripe/big{
	dir = 8
	},
/obj/cable{
	icon_state = "1-2"
	},
/obj/decal/tile_edge/stripe/big{
	dir = 6;
	icon_state = "bigstripe-corner2"
	},
/obj/decal/tile_edge/stripe/big{
	dir = 10;
	icon_state = "bigstripe-corner2"
	},
/obj/map/light/cyan,
/turf/simulated/floor/engine/glow/blue,
/area/station/engine/singcore)
"yr" = (
/obj/machinery/power/collector_array,
/obj/cable/reinforced{
	icon_state = "0-4-thick"
	},
/obj/cable/reinforced{
	icon_state = "0-8-thick"
	},
/turf/simulated/floor/yellow/side{
	dir = 1
	},
/area/station/engine/inner)
"yX" = (
/obj/decal/tile_edge/stripe/big{
	dir = 1
	},
/obj/cable/reinforced{
	icon_state = "1-2-thick"
	},
/turf/simulated/floor/yellow/side{
	dir = 8
	},
/area/station/engine/inner)
"zs" = (
/obj/machinery/power/data_terminal,
/obj/machinery/field_generator,
/obj/cable{
	icon_state = "0-4"
	},
/obj/cable{
	icon_state = "0-2"
	},
/obj/decal/tile_edge/stripe/extra_big{
	dir = 9;
	icon_state = "xtra_bigstripe-corner2"
	},
/obj/map/light/cyan,
/turf/simulated/floor/engine/glow/blue,
/area/station/engine/singcore)
"zA" = (
/obj/cable{
	icon_state = "1-4"
	},
/obj/stool/chair/yellow{
	dir = 1
	},
/turf/simulated/floor/yellow/side,
/area/station/engine/inner)
"AB" = (
/obj/cable{
	icon_state = "0-2"
	},
/obj/cable,
/obj/cable{
	icon_state = "0-4"
	},
/obj/decal/tile_edge/stripe/extra_big,
/obj/decal/tile_edge/stripe/extra_big{
	dir = 1
	},
/turf/simulated/floor/black,
/area/station/engine/inner)
"Bp" = (
/obj/decal/tile_edge/stripe/big{
	dir = 6;
	icon_state = "xtra_bigstripe-edge"
	},
/obj/decal/tile_edge/stripe/extra_big{
	dir = 10;
	icon_state = "xtra_bigstripe-corner2"
	},
/obj/map/light/cyan,
/turf/simulated/floor/engine/glow/blue,
/area/station/engine/singcore)
"BJ" = (
/turf/simulated/floor/yellow/corner{
	dir = 1
	},
/area/station/engine/inner)
"Cl" = (
/obj/decal/tile_edge/stripe/big{
	dir = 9;
	icon_state = "xtra_bigstripe-edge"
	},
/obj/decal/tile_edge/stripe/extra_big{
	dir = 10;
	icon_state = "xtra_bigstripe-corner2"
	},
/obj/map/light/cyan,
/turf/simulated/floor/engine/glow/blue,
/area/station/engine/singcore)
"DK" = (
/obj/cable/reinforced{
	icon_state = "1-4-thick"
	},
/turf/simulated/floor/yellow/side{
	dir = 5
	},
/area/station/engine/inner)
"EF" = (
/obj/decal/tile_edge/stripe/big,
/obj/cable/reinforced{
	icon_state = "1-2-thick"
	},
/turf/simulated/floor/yellow/side{
	dir = 8
	},
/area/station/engine/inner)
"Ff" = (
/obj/cable{
	icon_state = "0-2"
	},
/obj/cable{
	icon_state = "0-8"
	},
/obj/cable{
	icon_state = "0-4"
	},
/obj/mapping_helper/wingrille_spawn/auto/crystal,
/turf/simulated/floor/plating/jen,
/area/station/engine/singcore)
"FH" = (
/obj/decal/tile_edge/stripe/extra_big{
	dir = 8
	},
/obj/map/light/cyan,
/turf/simulated/floor/engine/glow/blue,
/area/station/engine/singcore)
"GC" = (
/obj/decal/tile_edge/stripe/extra_big{
	dir = 1
	},
/obj/decal/tile_edge/stripe/extra_big,
/obj/cable{
	icon_state = "4-8"
	},
/obj/cable/reinforced{
	icon_state = "1-2-thick"
	},
/turf/simulated/floor/black,
/area/station/engine/inner)
"GP" = (
/turf/simulated/floor,
/area/station/engine/inner)
"Hm" = (
/obj/decal/tile_edge/stripe/extra_big{
	dir = 10
	},
/obj/decal/tile_edge/stripe/extra_big{
	dir = 6;
	icon_state = "xtra_bigstripe-corner2"
	},
/obj/map/light/cyan,
/turf/simulated/floor/engine/glow/blue,
/area/station/engine/singcore)
"Hp" = (
/obj/machinery/camera/directional/north{
	c_tag = "Engineering North";
	pixel_x = -10
	},
/obj/machinery/light/incandescent{
	dir = 1
	},
/obj/decal/poster/wallsign/hazard_electrical{
	pixel_y = 32
	},
/obj/cable{
	icon_state = "4-8"
	},
/turf/simulated/floor/yellow/corner,
/area/station/engine/inner)
"Hz" = (
/obj/securearea{
	desc = "A warning sign telling of the dangers of gravitational singularities.  Apparently they are dangerous.";
	name = "Molecular Integrity Hazard";
	pixel_x = -4;
	pixel_y = -1
	},
/turf/simulated/wall/auto/reinforced/supernorn,
/area/station/engine/singcore)
"HC" = (
/obj/cable/reinforced{
	icon_state = "4-8-thick"
	},
/obj/cable{
	icon_state = "1-2"
	},
/turf/simulated/floor/yellow/side{
	dir = 9
	},
/area/station/engine/inner)
"IZ" = (
/obj/cable{
	icon_state = "0-8"
	},
/obj/cable,
/obj/mapping_helper/wingrille_spawn/auto/crystal,
/turf/simulated/floor/plating/jen,
/area/station/engine/singcore)
"Jp" = (
/obj/securearea{
	desc = "A warning sign telling of the dangers of gravitational singularities.  Apparently they are dangerous.";
	name = "Molecular Integrity Hazard";
	pixel_x = 4;
	pixel_y = 4
	},
/turf/simulated/wall/auto/reinforced/supernorn,
/area/station/engine/singcore)
"KF" = (
/obj/decal/tile_edge/stripe/big,
/turf/simulated/floor/yellow/side{
	dir = 8
	},
/area/station/engine/inner)
"KO" = (
/obj/cable,
/obj/cable{
	icon_state = "0-2"
	},
/obj/mapping_helper/wingrille_spawn/auto/crystal,
/turf/simulated/floor/plating/jen,
/area/station/engine/singcore)
"Lm" = (
/obj/decal/tile_edge/stripe/extra_big{
	dir = 5
	},
/obj/decal/tile_edge/stripe/extra_big{
	dir = 6;
	icon_state = "xtra_bigstripe-corner2"
	},
/obj/map/light/cyan,
/turf/simulated/floor/engine/glow/blue,
/area/station/engine/singcore)
"LW" = (
/obj/decal/tile_edge/stripe/extra_big{
	dir = 1
	},
/obj/map/light/cyan,
/turf/simulated/floor/engine/glow/blue,
/area/station/engine/singcore)
"Mf" = (
/obj/cable{
	icon_state = "0-8"
	},
/obj/cable,
/turf/simulated/floor/yellow/side,
/area/station/engine/inner)
"MF" = (
/obj/cable/reinforced{
	icon_state = "4-8-thick"
	},
/turf/simulated/floor,
/area/station/engine/inner)
"ML" = (
/obj/decal/tile_edge/stripe/big{
	dir = 1
	},
/obj/machinery/light/incandescent{
	dir = 4
	},
/obj/cable/reinforced{
	icon_state = "1-2-thick"
	},
/turf/simulated/floor/yellow/side{
	dir = 9
	},
/area/station/engine/inner)
"Nq" = (
/obj/decal/tile_edge/stripe/big{
	dir = 1
	},
/turf/simulated/floor/yellow/side{
	dir = 4
	},
/area/station/engine/inner)
"NF" = (
/obj/securearea{
	desc = "A warning sign telling of the dangers of gravitational singularities.  Apparently they are dangerous.";
	name = "Molecular Integrity Hazard";
	pixel_x = -4;
	pixel_y = 4
	},
/turf/simulated/wall/auto/reinforced/supernorn,
/area/station/engine/singcore)
"Oa" = (
/obj/cable,
/obj/cable{
	icon_state = "0-4"
	},
/obj/cable{
	icon_state = "0-8"
	},
/obj/mapping_helper/wingrille_spawn/auto/crystal,
/turf/simulated/floor/plating/jen,
/area/station/engine/singcore)
"Oi" = (
/obj/cable{
	icon_state = "1-2"
	},
/obj/decal/tile_edge/stripe/big{
	dir = 1
	},
/obj/machinery/light/incandescent{
	dir = 8
	},
/turf/simulated/floor/yellow/side{
	dir = 5
	},
/area/station/engine/inner)
"OL" = (
/turf/simulated/floor/yellow/side{
	dir = 4
	},
/area/station/engine/inner)
"Pc" = (
/obj/decal/tile_edge/stripe/big,
/obj/machinery/light/incandescent{
	dir = 4
	},
/obj/cable/reinforced{
	icon_state = "1-2-thick"
	},
/obj/machinery/emitter{
	dir = 1
	},
/turf/simulated/floor/yellow/side{
	dir = 10
	},
/area/station/engine/inner)
"PI" = (
/obj/cable{
	icon_state = "6-9"
	},
/turf/simulated/floor,
/area/station/engine/inner)
"PY" = (
/obj/cable{
	icon_state = "0-8"
	},
/obj/machinery/power/data_terminal,
/obj/decal/mule/dropoff,
/obj/decal/tile_edge/stripe/extra_big,
/obj/decal/tile_edge/stripe/extra_big{
	dir = 1
	},
/turf/simulated/floor/black,
/area/station/engine/inner)
"Qs" = (
/obj/cable,
/obj/cable{
	icon_state = "0-8"
	},
/obj/mapping_helper/wingrille_spawn/auto/crystal,
/turf/simulated/floor/plating/jen,
/area/station/engine/singcore)
"Rb" = (
/obj/securearea{
	desc = "A warning sign telling of the dangers of gravitational singularities.  Apparently they are dangerous.";
	name = "Molecular Integrity Hazard";
	pixel_x = 4;
	pixel_y = 1
	},
/turf/simulated/wall/auto/reinforced/supernorn,
/area/station/engine/singcore)
"SS" = (
/obj/machinery/emitter,
/turf/simulated/floor/yellow/side{
	dir = 8
	},
/area/station/engine/inner)
"SV" = (
/obj/cable/reinforced{
	icon_state = "4-8-thick"
	},
/obj/machinery/computer3/generic/engine,
/obj/machinery/power/data_terminal,
/obj/cable{
	icon_state = "0-2"
	},
/obj/item/device/radio/intercom/loudspeaker/speaker/south{
	pixel_y = 24
	},
/turf/simulated/floor/yellow/side{
	dir = 10
	},
/area/station/engine/inner)
"Tg" = (
/obj/machinery/door_control{
	id = "engi";
	name = "Engine Room Shield Control";
	pixel_x = -24
	},
/obj/machinery/emitter{
	dir = 8
	},
/turf/simulated/floor/yellow/corner{
	dir = 4
	},
/area/station/engine/inner)
"TK" = (
/obj/machinery/the_singularitygen,
/obj/cable,
/obj/machinery/power/data_terminal,
/turf/simulated/floor/engine,
/area/station/engine/singcore)
"UQ" = (
/obj/machinery/power/data_terminal,
/obj/cable{
	icon_state = "0-4"
	},
/obj/decal/mule/dropoff,
/obj/decal/tile_edge/stripe/extra_big,
/obj/decal/tile_edge/stripe/extra_big{
	dir = 1
	},
/turf/simulated/floor/black,
/area/station/engine/inner)
"Vh" = (
/obj/machinery/power/data_terminal,
/obj/cable{
	icon_state = "0-8"
	},
/obj/decal/mule/dropoff,
/obj/decal/tile_edge/stripe/extra_big{
	dir = 1
	},
/obj/decal/tile_edge/stripe/extra_big,
/turf/simulated/floor/black,
/area/station/engine/inner)
"Wc" = (
/obj/cable{
	icon_state = "0-4"
	},
/obj/cable{
	icon_state = "0-2"
	},
/obj/mapping_helper/wingrille_spawn/auto/crystal,
/turf/simulated/floor/plating/jen,
/area/station/engine/singcore)
"Wt" = (
/obj/cable{
	icon_state = "0-8"
	},
/obj/cable{
	icon_state = "0-2"
	},
/obj/decal/tile_edge/stripe/big,
/turf/simulated/floor/yellow/side{
	dir = 4
	},
/area/station/engine/inner)
"Xl" = (
/obj/decal/tile_edge/stripe/extra_big{
	dir = 9
	},
/obj/decal/tile_edge/stripe/extra_big{
	dir = 5;
	icon_state = "xtra_bigstripe-corner2"
	},
/obj/map/light/cyan,
/turf/simulated/floor/engine/glow/blue,
/area/station/engine/singcore)
"YH" = (
/turf/simulated/floor/yellow/side{
	dir = 10
	},
/area/station/engine/inner)
"YQ" = (
/obj/decal/tile_edge/stripe/big,
/obj/machinery/light/incandescent{
	dir = 8
	},
/turf/simulated/floor/yellow/side{
	dir = 6
	},
/area/station/engine/inner)
"ZW" = (
/obj/decal/tile_edge/stripe/big,
/turf/simulated/floor/yellow/side{
	dir = 4
	},
/area/station/engine/inner)

(1,1,1) = {"
Hp
GP
KF
UQ
cF
OL
jn
OL
KF
bT
cF
PI
Tg
"}
(2,1,1) = {"
mO
vk
Pc
GC
yX
ln
gr
ln
EF
GC
ML
DK
PI
"}
(3,1,1) = {"
rl
tv
Rb
cw
cx
KO
kg
cx
cx
Oa
Jp
dm
ce
"}
(4,1,1) = {"
Mf
ce
Wc
vQ
aW
ua
gR
ua
Bp
ux
xO
yr
gL
"}
(5,1,1) = {"
gL
gL
dx
jO
cB
cB
cB
cB
cB
Cl
dx
pI
ce
"}
(6,1,1) = {"
ce
ce
dx
iJ
cB
cB
cB
cB
cB
LW
dx
yr
gL
"}
(7,1,1) = {"
gL
gL
qt
yk
qL
qL
TK
qg
cB
LW
dx
pI
ce
"}
(8,1,1) = {"
ce
ce
dx
iJ
cB
cB
cB
cB
cB
LW
dx
yr
gL
"}
(9,1,1) = {"
gL
gL
dx
of
cB
cB
cB
cB
cB
Lm
dx
pI
ce
"}
(10,1,1) = {"
dT
ce
cj
jL
Xl
FH
dE
FH
Hm
zs
IZ
yr
gL
"}
(11,1,1) = {"
gL
uF
Hz
Ff
cx
KO
uU
cx
ho
Qs
NF
SV
zA
"}
(12,1,1) = {"
GP
YH
YQ
eW
Nq
jn
OL
SS
Wt
AB
Oi
HC
eI
"}
(13,1,1) = {"
pi
GP
ZW
Vh
Nq
jn
OL
jn
ZW
PY
Nq
MF
BJ
"}
