//MAP CONVERTED BY dmm2tgm.py THIS HEADER COMMENT PREVENTS RECONVERSION, DO NOT REMOVE
"a" = (
/turf/cordon,
/area/cordon/dark)
"b" = (
/obj/stool/chair/office/syndie{
	dir = 8;
	pixel_x = -19
	},
/turf/simulated/floor/carpet/green,
/area/syndicate_station/hideout)
"d" = (
/obj/landmark/viscontents_spawn{
	targetZ = 6;
	xOffset = 8
	},
/turf/simulated/floor/carpet/green,
/area/syndicate_station/hideout)
"g" = (
/obj/stool/chair{
	pixel_x = -6
	},
/obj/item/kitchen/utensil/fork{
	pixel_x = -6;
	pixel_y = 5
	},
/turf/simulated/floor/carpet/green,
/area/syndicate_station/hideout)
"j" = (
/obj/landmark/viscontents_spawn{
	targetZ = 6;
	yOffset = 1;
	xOffset = 8
	},
/turf/simulated/floor/carpet/green,
/area/syndicate_station/hideout)
"k" = (
/turf/unsimulated/wall/auto/adventure/hospital/interior{
	color = "#c6c671"
	},
/area/syndicate_station/hideout)
"l" = (
/obj/machinery/computer/camera_viewer{
	dir = 4
	},
/turf/simulated/floor/carpet/green,
/area/syndicate_station/hideout)
"m" = (
/obj/table/reinforced/auto{
	pixel_x = 5;
	pixel_y = 3
	},
/obj/machinery/microwave{
	pixel_x = -17;
	pixel_y = 17
	},
/obj/item/storage/box/donkpocket_kit{
	pixel_x = -15;
	pixel_y = 14
	},
/turf/simulated/floor/carpet/green,
/area/syndicate_station/hideout)
"o" = (
/turf/simulated/floor/carpet/green,
/area/syndicate_station/hideout)
"r" = (
/obj/machinery/light/incandescent/warm{
	dir = 1
	},
/turf/simulated/floor/carpet/green,
/area/syndicate_station/hideout)
"t" = (
/obj/table/reinforced/auto{
	pixel_x = 5;
	pixel_y = 3
	},
/obj/item/reagent_containers/food/snacks/miso_soup{
	pixel_x = -19
	},
/turf/simulated/floor/carpet/green,
/area/syndicate_station/hideout)
"v" = (
/obj/machinery/light/incandescent/warm{
	dir = 8
	},
/turf/simulated/floor/carpet/green,
/area/syndicate_station/hideout)
"y" = (
/obj/item/device/radio/intercom,
/turf/simulated/floor/carpet/green,
/area/syndicate_station/hideout)
"A" = (
/obj/landmark/viscontents_spawn{
	targetZ = 6;
	xOffset = -8
	},
/turf/simulated/floor/carpet/green,
/area/syndicate_station/hideout)
"F" = (
/obj/landmark/viscontents_spawn{
	xOffset = -8;
	yOffset = -1
	},
/turf/simulated/floor/carpet/green,
/area/syndicate_station/hideout)
"G" = (
/obj/machinery/light/incandescent/warm,
/obj/fakeobject/skeleton/decomposed_corpse,
/turf/simulated/floor/carpet/green,
/area/syndicate_station/hideout)
"H" = (
/obj/decoration/railyard/signal/pole,
/obj/decal/poster/wallsign/iso/prohibited,
/turf/simulated/floor/carpet/green,
/area/syndicate_station/hideout)
"I" = (
/turf/unsimulated/wall/auto/adventure/hospital/interior{
	icon = 'icons/turf/floors/carpet.dmi';
	icon_state = "green1"
	},
/area/syndicate_station/hideout)
"P" = (
/obj/table/reinforced/auto{
	pixel_x = 5;
	pixel_y = 3
	},
/turf/simulated/floor/carpet/green,
/area/syndicate_station/hideout)
"R" = (
/obj/item/storage/toilet/random/escapetools{
	pixel_y = 34
	},
/turf/simulated/floor/carpet/green,
/area/syndicate_station/hideout)
"S" = (
/obj/machinery/disposal/extradimensional/exit{
	pixel_y = 3
	},
/turf/simulated/floor/carpet/green,
/area/syndicate_station/hideout)
"U" = (
/obj/machinery/light/incandescent/warm,
/turf/simulated/floor/carpet/green,
/area/syndicate_station/hideout)
"V" = (
/obj/machinery/light/incandescent/warm{
	dir = 4
	},
/turf/simulated/floor/carpet/green,
/area/syndicate_station/hideout)
"W" = (
/obj/machinery/light/incandescent/warm,
/obj/table/reinforced/auto{
	pixel_x = 5;
	pixel_y = 3
	},
/turf/simulated/floor/carpet/green,
/area/syndicate_station/hideout)
"X" = (
/obj/table/wood/auto/desk,
/obj/machinery/light/incandescent/warm{
	dir = 8
	},
/turf/simulated/floor/carpet/green,
/area/syndicate_station/hideout)
"Z" = (
/obj/table/wood/auto/desk,
/obj/item/cash_briefcase/syndicate{
	pixel_y = 5
	},
/obj/item/reagent_containers/food/snacks/cereal_box/syndie{
	pixel_x = 7;
	pixel_y = 14
	},
/turf/simulated/floor/carpet/green,
/area/syndicate_station/hideout)

(1,1,1) = {"
a
a
a
a
a
a
a
a
a
a
a
a
a
"}
(2,1,1) = {"
a
k
I
I
k
k
I
k
k
k
k
k
a
"}
(3,1,1) = {"
a
k
d
d
k
k
j
k
o
m
P
k
a
"}
(4,1,1) = {"
a
k
r
o
o
o
G
k
r
o
W
k
a
"}
(5,1,1) = {"
a
k
H
o
k
k
k
k
o
g
t
k
a
"}
(6,1,1) = {"
a
k
o
o
k
k
R
o
o
o
o
k
a
"}
(7,1,1) = {"
a
k
r
o
k
k
r
k
r
S
U
k
a
"}
(8,1,1) = {"
a
k
o
o
o
o
o
k
k
k
k
k
a
"}
(9,1,1) = {"
a
k
o
o
k
k
k
k
Z
X
l
k
a
"}
(10,1,1) = {"
a
k
r
o
k
v
o
o
o
b
o
k
a
"}
(11,1,1) = {"
a
k
A
A
k
F
k
k
y
V
o
k
a
"}
(12,1,1) = {"
a
k
I
I
k
I
k
k
k
k
k
k
a
"}
(13,1,1) = {"
a
a
a
a
a
a
a
a
a
a
a
a
a
"}
